1001111111110001010
1101000101000101010
2101101100011101010
0110100000010100010
0010110111110101010
1010100001010101010
1010001101010101010
1011011111010101000
1010010001010101010
0010010100030001010
0010000101000101010
0011111111101101011
0000000000001101000
0111111110101100000
0010000011111111110
1010001010000000010
1011111010111011110
1000000000100000000
1111111111111111111