1001111111110001310
1101000101000101010
2101101100011101010
0100001101010001010
0111101101000111010
0010001100011101010
1010100001000001010
1000001001010001000
1011111111011111010
1010000100010001010
0010110101010000010
0110000101011011111
0010110101010001000
0110100000010100010
0010110111110101010
1010100001010101010
1010001101010101010
1011011111010101000
1110010001010101010
