0111110101001000000
0100000101111011110
0101011101001011310
0001000100011000010
0101111110111111110
1111010000001010100
0100010101101010110
0101110100101010110
0001000100101000100
0111110111101001101
0001000100001101000
0100011100101001010
0111010101101001010
0101110100101011010
0100000111101000010
0111110110101011010
0000210100100000000
0111110101101110110
0000000100001000000
