1111111111111111111
1101000102000101011
1101101100011101011
1110100000010100011
1010110111110101011
1010100001010101011
1010001101010101011
1011011111010101001
1010010001010101011
1010010100030001011
1010000101000101011
1011111111101101011
1000000000001101001
1111111110101100001
1010000011111111111
1010001010000000011
1011111010111011111
1001000010000100011
1111111111111111111